64x64 frame (full board via Camera pipeline):

[5, 5, 5, 5, 5, 5, 5, 5, 5, 5, 5, 5, 5, 5, 5, 5, 5, 5, 5, 5, 5, 5, 5, 5, 5, 5, 5, 5, 5, 5, 5, 5, 5, 5, 5, 5, 5, 5, 5, 5, 5, 5, 5, 5, 5, 5, 5, 5, 5, 5, 5, 5, 5, 5, 5, 5, 5, 5, 5, 5, 5, 5, 5, 5]
[5, 5, 5, 5, 5, 5, 5, 5, 5, 5, 5, 5, 5, 5, 5, 5, 5, 5, 5, 5, 5, 5, 5, 5, 5, 5, 5, 5, 5, 5, 5, 5, 5, 5, 5, 5, 5, 5, 5, 5, 5, 5, 5, 5, 5, 5, 5, 5, 5, 5, 5, 5, 5, 5, 5, 5, 5, 5, 5, 5, 5, 5, 5, 5]
[5, 5, 5, 5, 9, 9, 9, 9, 9, 9, 5, 5, 8, 8, 8, 8, 8, 8, 5, 5, 9, 9, 9, 9, 9, 9, 5, 5, 5, 5, 5, 5, 5, 5, 5, 5, 5, 5, 9, 9, 9, 9, 9, 9, 5, 5, 8, 8, 8, 8, 8, 8, 5, 5, 9, 9, 9, 9, 9, 9, 5, 5, 5, 5]
[5, 5, 5, 5, 9, 9, 9, 9, 9, 9, 5, 5, 8, 8, 8, 8, 8, 8, 5, 5, 9, 9, 9, 9, 9, 9, 5, 5, 5, 5, 5, 5, 5, 5, 5, 5, 5, 5, 9, 9, 9, 9, 9, 9, 5, 5, 8, 8, 8, 8, 8, 8, 5, 5, 9, 9, 9, 9, 9, 9, 5, 5, 5, 5]
[5, 5, 5, 5, 9, 9, 9, 9, 9, 9, 5, 5, 8, 8, 8, 8, 8, 8, 5, 5, 9, 9, 9, 9, 9, 9, 5, 5, 5, 5, 5, 5, 5, 5, 5, 5, 5, 5, 9, 9, 9, 9, 9, 9, 5, 5, 8, 8, 8, 8, 8, 8, 5, 5, 9, 9, 9, 9, 9, 9, 5, 5, 5, 5]
[5, 5, 5, 5, 9, 9, 9, 9, 9, 9, 5, 5, 8, 8, 8, 8, 8, 8, 5, 5, 9, 9, 9, 9, 9, 9, 5, 5, 5, 5, 5, 5, 5, 5, 5, 5, 5, 5, 9, 9, 9, 9, 9, 9, 5, 5, 8, 8, 8, 8, 8, 8, 5, 5, 9, 9, 9, 9, 9, 9, 5, 5, 5, 5]
[5, 5, 5, 5, 9, 9, 9, 9, 9, 9, 5, 5, 8, 8, 8, 8, 8, 8, 5, 5, 9, 9, 9, 9, 9, 9, 5, 5, 5, 5, 5, 5, 5, 5, 5, 5, 5, 5, 9, 9, 9, 9, 9, 9, 5, 5, 8, 8, 8, 8, 8, 8, 5, 5, 9, 9, 9, 9, 9, 9, 5, 5, 5, 5]
[5, 5, 5, 5, 9, 9, 9, 9, 9, 9, 5, 5, 8, 8, 8, 8, 8, 8, 5, 5, 9, 9, 9, 9, 9, 9, 5, 5, 5, 5, 5, 5, 5, 5, 5, 5, 5, 5, 9, 9, 9, 9, 9, 9, 5, 5, 8, 8, 8, 8, 8, 8, 5, 5, 9, 9, 9, 9, 9, 9, 5, 5, 5, 5]
[5, 5, 5, 5, 5, 5, 5, 5, 5, 5, 5, 5, 5, 5, 5, 5, 5, 5, 5, 5, 5, 5, 5, 5, 5, 5, 5, 5, 5, 5, 5, 5, 5, 5, 5, 5, 5, 5, 5, 5, 5, 5, 5, 5, 5, 5, 5, 5, 5, 5, 5, 5, 5, 5, 5, 5, 5, 5, 5, 5, 5, 5, 5, 5]
[5, 5, 5, 5, 5, 5, 5, 5, 5, 5, 5, 5, 5, 5, 5, 5, 5, 5, 5, 5, 5, 5, 5, 5, 5, 5, 5, 5, 5, 5, 5, 5, 5, 5, 5, 5, 5, 5, 5, 5, 5, 5, 5, 5, 5, 5, 5, 5, 5, 5, 5, 5, 5, 5, 5, 5, 5, 5, 5, 5, 5, 5, 5, 5]
[5, 5, 5, 5, 8, 8, 8, 8, 8, 8, 5, 5, 2, 2, 0, 0, 2, 2, 5, 5, 9, 9, 9, 9, 9, 9, 5, 5, 5, 5, 5, 5, 5, 5, 5, 5, 5, 5, 8, 8, 8, 8, 8, 8, 5, 5, 2, 2, 0, 0, 2, 2, 5, 5, 8, 8, 8, 8, 8, 8, 5, 5, 5, 5]
[5, 5, 5, 5, 8, 8, 8, 8, 8, 8, 5, 5, 2, 2, 0, 0, 2, 2, 5, 5, 9, 9, 9, 9, 9, 9, 5, 5, 5, 5, 5, 5, 5, 5, 5, 5, 5, 5, 8, 8, 8, 8, 8, 8, 5, 5, 2, 2, 0, 0, 2, 2, 5, 5, 8, 8, 8, 8, 8, 8, 5, 5, 5, 5]
[5, 5, 5, 5, 8, 8, 8, 8, 8, 8, 5, 5, 0, 0, 8, 8, 2, 2, 5, 5, 9, 9, 9, 9, 9, 9, 5, 5, 5, 5, 5, 5, 5, 5, 5, 5, 5, 5, 8, 8, 8, 8, 8, 8, 5, 5, 0, 0, 8, 8, 0, 0, 5, 5, 8, 8, 8, 8, 8, 8, 5, 5, 5, 5]
[5, 5, 5, 5, 8, 8, 8, 8, 8, 8, 5, 5, 0, 0, 8, 8, 2, 2, 5, 5, 9, 9, 9, 9, 9, 9, 5, 5, 5, 5, 5, 5, 5, 5, 5, 5, 5, 5, 8, 8, 8, 8, 8, 8, 5, 5, 0, 0, 8, 8, 0, 0, 5, 5, 8, 8, 8, 8, 8, 8, 5, 5, 5, 5]
[5, 5, 5, 5, 8, 8, 8, 8, 8, 8, 5, 5, 2, 2, 0, 0, 0, 0, 5, 5, 9, 9, 9, 9, 9, 9, 5, 5, 5, 5, 5, 5, 5, 5, 5, 5, 5, 5, 8, 8, 8, 8, 8, 8, 5, 5, 2, 2, 0, 0, 2, 2, 5, 5, 8, 8, 8, 8, 8, 8, 5, 5, 5, 5]
[5, 5, 5, 5, 8, 8, 8, 8, 8, 8, 5, 5, 2, 2, 0, 0, 0, 0, 5, 5, 9, 9, 9, 9, 9, 9, 5, 5, 5, 5, 5, 5, 5, 5, 5, 5, 5, 5, 8, 8, 8, 8, 8, 8, 5, 5, 2, 2, 0, 0, 2, 2, 5, 5, 8, 8, 8, 8, 8, 8, 5, 5, 5, 5]
[5, 5, 5, 5, 5, 5, 5, 5, 5, 5, 5, 5, 5, 5, 5, 5, 5, 5, 5, 5, 5, 5, 5, 5, 5, 5, 5, 5, 5, 5, 5, 5, 5, 5, 5, 5, 5, 5, 5, 5, 5, 5, 5, 5, 5, 5, 5, 5, 5, 5, 5, 5, 5, 5, 5, 5, 5, 5, 5, 5, 5, 5, 5, 5]
[5, 5, 5, 5, 5, 5, 5, 5, 5, 5, 5, 5, 5, 5, 5, 5, 5, 5, 5, 5, 5, 5, 5, 5, 5, 5, 5, 5, 5, 5, 5, 5, 5, 5, 5, 5, 5, 5, 5, 5, 5, 5, 5, 5, 5, 5, 5, 5, 5, 5, 5, 5, 5, 5, 5, 5, 5, 5, 5, 5, 5, 5, 5, 5]
[5, 5, 5, 5, 9, 9, 9, 9, 9, 9, 5, 5, 8, 8, 8, 8, 8, 8, 5, 5, 8, 8, 8, 8, 8, 8, 5, 5, 5, 5, 5, 5, 5, 5, 5, 5, 5, 5, 9, 9, 9, 9, 9, 9, 5, 5, 8, 8, 8, 8, 8, 8, 5, 5, 9, 9, 9, 9, 9, 9, 5, 5, 5, 5]
[5, 5, 5, 5, 9, 9, 9, 9, 9, 9, 5, 5, 8, 8, 8, 8, 8, 8, 5, 5, 8, 8, 8, 8, 8, 8, 5, 5, 5, 5, 5, 5, 5, 5, 5, 5, 5, 5, 9, 9, 9, 9, 9, 9, 5, 5, 8, 8, 8, 8, 8, 8, 5, 5, 9, 9, 9, 9, 9, 9, 5, 5, 5, 5]
[5, 5, 5, 5, 9, 9, 9, 9, 9, 9, 5, 5, 8, 8, 8, 8, 8, 8, 5, 5, 8, 8, 8, 8, 8, 8, 5, 5, 5, 5, 5, 5, 5, 5, 5, 5, 5, 5, 9, 9, 9, 9, 9, 9, 5, 5, 8, 8, 8, 8, 8, 8, 5, 5, 9, 9, 9, 9, 9, 9, 5, 5, 5, 5]
[5, 5, 5, 5, 9, 9, 9, 9, 9, 9, 5, 5, 8, 8, 8, 8, 8, 8, 5, 5, 8, 8, 8, 8, 8, 8, 5, 5, 5, 5, 5, 5, 5, 5, 5, 5, 5, 5, 9, 9, 9, 9, 9, 9, 5, 5, 8, 8, 8, 8, 8, 8, 5, 5, 9, 9, 9, 9, 9, 9, 5, 5, 5, 5]
[5, 5, 5, 5, 9, 9, 9, 9, 9, 9, 5, 5, 8, 8, 8, 8, 8, 8, 5, 5, 8, 8, 8, 8, 8, 8, 5, 5, 5, 5, 5, 5, 5, 5, 5, 5, 5, 5, 9, 9, 9, 9, 9, 9, 5, 5, 8, 8, 8, 8, 8, 8, 5, 5, 9, 9, 9, 9, 9, 9, 5, 5, 5, 5]
[5, 5, 5, 5, 9, 9, 9, 9, 9, 9, 5, 5, 8, 8, 8, 8, 8, 8, 5, 5, 8, 8, 8, 8, 8, 8, 5, 5, 5, 5, 5, 5, 5, 5, 5, 5, 5, 5, 9, 9, 9, 9, 9, 9, 5, 5, 8, 8, 8, 8, 8, 8, 5, 5, 9, 9, 9, 9, 9, 9, 5, 5, 5, 5]
[5, 5, 5, 5, 5, 5, 5, 5, 5, 5, 5, 5, 5, 5, 5, 5, 5, 5, 5, 5, 5, 5, 5, 5, 5, 5, 5, 5, 5, 5, 5, 5, 5, 5, 5, 5, 5, 5, 5, 5, 5, 5, 5, 5, 5, 5, 5, 5, 5, 5, 5, 5, 5, 5, 5, 5, 5, 5, 5, 5, 5, 5, 5, 5]
[5, 5, 5, 5, 5, 5, 5, 5, 5, 5, 5, 5, 5, 5, 5, 5, 5, 5, 5, 5, 5, 5, 5, 5, 5, 5, 5, 5, 5, 5, 5, 5, 5, 5, 5, 5, 5, 5, 5, 5, 5, 5, 5, 5, 5, 5, 5, 5, 5, 5, 5, 5, 5, 5, 5, 5, 5, 5, 5, 5, 5, 5, 5, 5]
[5, 5, 5, 5, 5, 5, 5, 5, 5, 5, 5, 5, 5, 5, 5, 5, 5, 5, 5, 5, 5, 5, 5, 5, 5, 5, 5, 5, 5, 5, 5, 5, 5, 5, 5, 5, 5, 5, 5, 5, 5, 5, 5, 5, 5, 5, 5, 5, 5, 5, 5, 5, 5, 5, 5, 5, 5, 5, 5, 5, 5, 5, 5, 5]
[5, 5, 5, 5, 5, 5, 5, 5, 5, 5, 5, 5, 5, 5, 5, 5, 5, 5, 5, 5, 5, 5, 5, 5, 5, 5, 5, 5, 5, 5, 5, 5, 5, 5, 5, 5, 5, 5, 5, 5, 5, 5, 5, 5, 5, 5, 5, 5, 5, 5, 5, 5, 5, 5, 5, 5, 5, 5, 5, 5, 5, 5, 5, 5]
[5, 5, 5, 5, 5, 5, 5, 5, 5, 5, 5, 5, 5, 5, 5, 5, 5, 5, 5, 5, 5, 5, 5, 5, 5, 5, 5, 5, 5, 5, 5, 5, 5, 5, 5, 5, 5, 5, 5, 5, 5, 5, 5, 5, 5, 5, 5, 5, 5, 5, 5, 5, 5, 5, 5, 5, 5, 5, 5, 5, 5, 5, 5, 5]
[5, 5, 5, 5, 5, 5, 5, 5, 5, 5, 5, 5, 5, 5, 5, 5, 5, 5, 5, 5, 5, 5, 5, 5, 5, 5, 5, 5, 5, 5, 5, 5, 5, 5, 5, 5, 5, 5, 5, 5, 5, 5, 5, 5, 5, 5, 5, 5, 5, 5, 5, 5, 5, 5, 5, 5, 5, 5, 5, 5, 5, 5, 5, 5]
[5, 5, 5, 5, 5, 5, 5, 5, 5, 5, 5, 5, 5, 5, 5, 5, 5, 5, 5, 5, 5, 5, 5, 5, 5, 5, 5, 5, 5, 5, 5, 5, 5, 5, 5, 5, 5, 5, 5, 5, 5, 5, 5, 5, 5, 5, 5, 5, 5, 5, 5, 5, 5, 5, 5, 5, 5, 5, 5, 5, 5, 5, 5, 5]
[5, 5, 5, 5, 5, 5, 5, 5, 5, 5, 5, 5, 5, 5, 5, 5, 5, 5, 5, 5, 5, 5, 5, 5, 5, 5, 5, 5, 5, 5, 5, 5, 5, 5, 5, 5, 5, 5, 5, 5, 5, 5, 5, 5, 5, 5, 5, 5, 5, 5, 5, 5, 5, 5, 5, 5, 5, 5, 5, 5, 5, 5, 5, 5]
[5, 5, 5, 5, 5, 5, 5, 5, 5, 5, 5, 5, 5, 5, 5, 5, 5, 5, 5, 5, 5, 5, 5, 5, 5, 5, 5, 5, 5, 5, 5, 5, 2, 2, 2, 2, 2, 2, 4, 4, 4, 4, 4, 4, 4, 4, 4, 4, 4, 4, 4, 4, 4, 4, 4, 4, 2, 2, 2, 2, 2, 2, 5, 5]
[5, 5, 5, 5, 5, 5, 5, 5, 5, 5, 5, 5, 5, 5, 5, 5, 5, 5, 5, 5, 5, 5, 5, 5, 5, 5, 5, 5, 5, 5, 5, 5, 2, 2, 2, 2, 2, 2, 4, 4, 4, 4, 4, 4, 4, 4, 4, 4, 4, 4, 4, 4, 4, 4, 4, 4, 2, 2, 2, 2, 2, 2, 5, 5]
[5, 5, 5, 5, 5, 5, 5, 5, 5, 5, 5, 5, 5, 5, 5, 5, 5, 5, 5, 5, 5, 5, 5, 5, 5, 5, 5, 5, 5, 5, 5, 5, 2, 2, 4, 4, 4, 4, 4, 4, 4, 4, 4, 4, 4, 4, 4, 4, 4, 4, 4, 4, 4, 4, 4, 4, 4, 4, 4, 4, 2, 2, 5, 5]
[5, 5, 5, 5, 5, 5, 5, 5, 5, 5, 5, 5, 5, 5, 5, 5, 5, 5, 5, 5, 5, 5, 5, 5, 5, 5, 5, 5, 5, 5, 5, 5, 2, 2, 4, 4, 4, 4, 4, 4, 4, 4, 4, 4, 4, 4, 4, 4, 4, 4, 4, 4, 4, 4, 4, 4, 4, 4, 4, 4, 2, 2, 5, 5]
[5, 5, 5, 5, 8, 8, 8, 8, 8, 8, 5, 5, 9, 9, 9, 9, 9, 9, 5, 5, 9, 9, 9, 9, 9, 9, 5, 5, 5, 5, 5, 5, 2, 2, 4, 4, 9, 9, 9, 9, 9, 9, 4, 4, 9, 9, 9, 9, 9, 9, 4, 4, 9, 9, 9, 9, 9, 9, 4, 4, 2, 2, 5, 5]
[5, 5, 5, 5, 8, 8, 8, 8, 8, 8, 5, 5, 9, 9, 9, 9, 9, 9, 5, 5, 9, 9, 9, 9, 9, 9, 5, 5, 5, 5, 5, 5, 2, 2, 4, 4, 9, 9, 9, 9, 9, 9, 4, 4, 9, 9, 9, 9, 9, 9, 4, 4, 9, 9, 9, 9, 9, 9, 4, 4, 2, 2, 5, 5]
[5, 5, 5, 5, 8, 8, 8, 8, 8, 8, 5, 5, 9, 9, 9, 9, 9, 9, 5, 5, 9, 9, 9, 9, 9, 9, 5, 5, 5, 5, 5, 5, 4, 4, 4, 4, 9, 9, 9, 9, 9, 9, 4, 4, 9, 9, 9, 9, 9, 9, 4, 4, 9, 9, 9, 9, 9, 9, 4, 4, 4, 4, 5, 5]
[5, 5, 5, 5, 8, 8, 8, 8, 8, 8, 5, 5, 9, 9, 9, 9, 9, 9, 5, 5, 9, 9, 9, 9, 9, 9, 5, 5, 5, 5, 5, 5, 4, 4, 4, 4, 9, 9, 9, 9, 9, 9, 4, 4, 9, 9, 9, 9, 9, 9, 4, 4, 9, 9, 9, 9, 9, 9, 4, 4, 4, 4, 5, 5]
[5, 5, 5, 5, 8, 8, 8, 8, 8, 8, 5, 5, 9, 9, 9, 9, 9, 9, 5, 5, 9, 9, 9, 9, 9, 9, 5, 5, 5, 5, 5, 5, 4, 4, 4, 4, 9, 9, 9, 9, 9, 9, 4, 4, 9, 9, 9, 9, 9, 9, 4, 4, 9, 9, 9, 9, 9, 9, 4, 4, 4, 4, 5, 5]
[5, 5, 5, 5, 8, 8, 8, 8, 8, 8, 5, 5, 9, 9, 9, 9, 9, 9, 5, 5, 9, 9, 9, 9, 9, 9, 5, 5, 5, 5, 5, 5, 4, 4, 4, 4, 9, 9, 9, 9, 9, 9, 4, 4, 9, 9, 9, 9, 9, 9, 4, 4, 9, 9, 9, 9, 9, 9, 4, 4, 4, 4, 5, 5]
[5, 5, 5, 5, 5, 5, 5, 5, 5, 5, 5, 5, 5, 5, 5, 5, 5, 5, 5, 5, 5, 5, 5, 5, 5, 5, 5, 5, 5, 5, 5, 5, 4, 4, 4, 4, 4, 4, 4, 4, 4, 4, 4, 4, 4, 4, 4, 4, 4, 4, 4, 4, 4, 4, 4, 4, 4, 4, 4, 4, 4, 4, 5, 5]
[5, 5, 5, 5, 5, 5, 5, 5, 5, 5, 5, 5, 5, 5, 5, 5, 5, 5, 5, 5, 5, 5, 5, 5, 5, 5, 5, 5, 5, 5, 5, 5, 4, 4, 4, 4, 4, 4, 4, 4, 4, 4, 4, 4, 4, 4, 4, 4, 4, 4, 4, 4, 4, 4, 4, 4, 4, 4, 4, 4, 4, 4, 5, 5]
[5, 5, 5, 5, 8, 8, 8, 8, 8, 8, 5, 5, 0, 0, 2, 2, 2, 2, 5, 5, 8, 8, 8, 8, 8, 8, 5, 5, 5, 5, 5, 5, 4, 4, 4, 4, 9, 9, 9, 9, 9, 9, 4, 4, 0, 0, 2, 2, 2, 2, 4, 4, 9, 9, 9, 9, 9, 9, 4, 4, 4, 4, 5, 5]
[5, 5, 5, 5, 8, 8, 8, 8, 8, 8, 5, 5, 0, 0, 2, 2, 2, 2, 5, 5, 8, 8, 8, 8, 8, 8, 5, 5, 5, 5, 5, 5, 4, 4, 4, 4, 9, 9, 9, 9, 9, 9, 4, 4, 0, 0, 2, 2, 2, 2, 4, 4, 9, 9, 9, 9, 9, 9, 4, 4, 4, 4, 5, 5]
[5, 5, 5, 5, 8, 8, 8, 8, 8, 8, 5, 5, 0, 0, 8, 8, 0, 0, 5, 5, 8, 8, 8, 8, 8, 8, 5, 5, 5, 5, 5, 5, 4, 4, 4, 4, 9, 9, 9, 9, 9, 9, 4, 4, 0, 0, 8, 8, 0, 0, 4, 4, 9, 9, 9, 9, 9, 9, 4, 4, 4, 4, 5, 5]
[5, 5, 5, 5, 8, 8, 8, 8, 8, 8, 5, 5, 0, 0, 8, 8, 0, 0, 5, 5, 8, 8, 8, 8, 8, 8, 5, 5, 5, 5, 5, 5, 4, 4, 4, 4, 9, 9, 9, 9, 9, 9, 4, 4, 0, 0, 8, 8, 0, 0, 4, 4, 9, 9, 9, 9, 9, 9, 4, 4, 4, 4, 5, 5]
[5, 5, 5, 5, 8, 8, 8, 8, 8, 8, 5, 5, 2, 2, 2, 2, 0, 0, 5, 5, 8, 8, 8, 8, 8, 8, 5, 5, 5, 5, 5, 5, 4, 4, 4, 4, 9, 9, 9, 9, 9, 9, 4, 4, 0, 0, 2, 2, 2, 2, 4, 4, 9, 9, 9, 9, 9, 9, 4, 4, 4, 4, 5, 5]
[5, 5, 5, 5, 8, 8, 8, 8, 8, 8, 5, 5, 2, 2, 2, 2, 0, 0, 5, 5, 8, 8, 8, 8, 8, 8, 5, 5, 5, 5, 5, 5, 4, 4, 4, 4, 9, 9, 9, 9, 9, 9, 4, 4, 0, 0, 2, 2, 2, 2, 4, 4, 9, 9, 9, 9, 9, 9, 4, 4, 4, 4, 5, 5]
[5, 5, 5, 5, 5, 5, 5, 5, 5, 5, 5, 5, 5, 5, 5, 5, 5, 5, 5, 5, 5, 5, 5, 5, 5, 5, 5, 5, 5, 5, 5, 5, 4, 4, 4, 4, 4, 4, 4, 4, 4, 4, 4, 4, 4, 4, 4, 4, 4, 4, 4, 4, 4, 4, 4, 4, 4, 4, 4, 4, 4, 4, 5, 5]
[5, 5, 5, 5, 5, 5, 5, 5, 5, 5, 5, 5, 5, 5, 5, 5, 5, 5, 5, 5, 5, 5, 5, 5, 5, 5, 5, 5, 5, 5, 5, 5, 4, 4, 4, 4, 4, 4, 4, 4, 4, 4, 4, 4, 4, 4, 4, 4, 4, 4, 4, 4, 4, 4, 4, 4, 4, 4, 4, 4, 4, 4, 5, 5]
[5, 5, 5, 5, 9, 9, 9, 9, 9, 9, 5, 5, 9, 9, 9, 9, 9, 9, 5, 5, 8, 8, 8, 8, 8, 8, 5, 5, 5, 5, 5, 5, 4, 4, 4, 4, 9, 9, 9, 9, 9, 9, 4, 4, 9, 9, 9, 9, 9, 9, 4, 4, 9, 9, 9, 9, 9, 9, 4, 4, 4, 4, 5, 5]
[5, 5, 5, 5, 9, 9, 9, 9, 9, 9, 5, 5, 9, 9, 9, 9, 9, 9, 5, 5, 8, 8, 8, 8, 8, 8, 5, 5, 5, 5, 5, 5, 4, 4, 4, 4, 9, 9, 9, 9, 9, 9, 4, 4, 9, 9, 9, 9, 9, 9, 4, 4, 9, 9, 9, 9, 9, 9, 4, 4, 4, 4, 5, 5]
[5, 5, 5, 5, 9, 9, 9, 9, 9, 9, 5, 5, 9, 9, 9, 9, 9, 9, 5, 5, 8, 8, 8, 8, 8, 8, 5, 5, 5, 5, 5, 5, 4, 4, 4, 4, 9, 9, 9, 9, 9, 9, 4, 4, 9, 9, 9, 9, 9, 9, 4, 4, 9, 9, 9, 9, 9, 9, 4, 4, 4, 4, 5, 5]
[5, 5, 5, 5, 9, 9, 9, 9, 9, 9, 5, 5, 9, 9, 9, 9, 9, 9, 5, 5, 8, 8, 8, 8, 8, 8, 5, 5, 5, 5, 5, 5, 4, 4, 4, 4, 9, 9, 9, 9, 9, 9, 4, 4, 9, 9, 9, 9, 9, 9, 4, 4, 9, 9, 9, 9, 9, 9, 4, 4, 4, 4, 5, 5]
[5, 5, 5, 5, 9, 9, 9, 9, 9, 9, 5, 5, 9, 9, 9, 9, 9, 9, 5, 5, 8, 8, 8, 8, 8, 8, 5, 5, 5, 5, 5, 5, 2, 2, 4, 4, 9, 9, 9, 9, 9, 9, 4, 4, 9, 9, 9, 9, 9, 9, 4, 4, 9, 9, 9, 9, 9, 9, 4, 4, 2, 2, 5, 5]
[5, 5, 5, 5, 9, 9, 9, 9, 9, 9, 5, 5, 9, 9, 9, 9, 9, 9, 5, 5, 8, 8, 8, 8, 8, 8, 5, 5, 5, 5, 5, 5, 2, 2, 4, 4, 9, 9, 9, 9, 9, 9, 4, 4, 9, 9, 9, 9, 9, 9, 4, 4, 9, 9, 9, 9, 9, 9, 4, 4, 2, 2, 5, 5]
[5, 5, 5, 5, 5, 5, 5, 5, 5, 5, 5, 5, 5, 5, 5, 5, 5, 5, 5, 5, 5, 5, 5, 5, 5, 5, 5, 5, 5, 5, 5, 5, 2, 2, 4, 4, 4, 4, 4, 4, 4, 4, 4, 4, 4, 4, 4, 4, 4, 4, 4, 4, 4, 4, 4, 4, 4, 4, 4, 4, 2, 2, 5, 5]
[5, 5, 5, 5, 5, 5, 5, 5, 5, 5, 5, 5, 5, 5, 5, 5, 5, 5, 5, 5, 5, 5, 5, 5, 5, 5, 5, 5, 5, 5, 5, 5, 2, 2, 4, 4, 4, 4, 4, 4, 4, 4, 4, 4, 4, 4, 4, 4, 4, 4, 4, 4, 4, 4, 4, 4, 4, 4, 4, 4, 2, 2, 5, 5]
[5, 5, 5, 5, 5, 5, 5, 5, 5, 5, 5, 5, 5, 5, 5, 5, 5, 5, 5, 5, 5, 5, 5, 5, 5, 5, 5, 5, 5, 5, 5, 5, 2, 2, 2, 2, 2, 2, 4, 4, 4, 4, 4, 4, 4, 4, 4, 4, 4, 4, 4, 4, 4, 4, 4, 4, 2, 2, 2, 2, 2, 2, 5, 5]
[5, 5, 5, 5, 5, 5, 5, 5, 5, 5, 5, 5, 5, 5, 5, 5, 5, 5, 5, 5, 5, 5, 5, 5, 5, 5, 5, 5, 5, 5, 5, 5, 2, 2, 2, 2, 2, 2, 4, 4, 4, 4, 4, 4, 4, 4, 4, 4, 4, 4, 4, 4, 4, 4, 4, 4, 2, 2, 2, 2, 2, 2, 5, 5]
[5, 5, 5, 5, 5, 5, 5, 5, 5, 5, 5, 5, 5, 5, 5, 5, 5, 5, 5, 5, 5, 5, 5, 5, 5, 5, 5, 5, 5, 5, 5, 5, 5, 5, 5, 5, 5, 5, 5, 5, 5, 5, 5, 5, 5, 5, 5, 5, 5, 5, 5, 5, 5, 5, 5, 5, 5, 5, 5, 5, 5, 5, 5, 5]
[12, 12, 12, 12, 12, 12, 12, 12, 12, 12, 12, 12, 12, 12, 12, 12, 12, 12, 12, 12, 12, 12, 12, 12, 12, 12, 12, 12, 12, 12, 12, 12, 12, 12, 12, 12, 12, 12, 12, 12, 12, 12, 12, 12, 12, 12, 12, 12, 12, 12, 12, 12, 12, 12, 12, 12, 12, 12, 12, 12, 12, 12, 12, 12]





32x32 native resolution (every other cell from 64x64):

[5, 5, 5, 5, 5, 5, 5, 5, 5, 5, 5, 5, 5, 5, 5, 5, 5, 5, 5, 5, 5, 5, 5, 5, 5, 5, 5, 5, 5, 5, 5, 5]
[5, 5, 9, 9, 9, 5, 8, 8, 8, 5, 9, 9, 9, 5, 5, 5, 5, 5, 5, 9, 9, 9, 5, 8, 8, 8, 5, 9, 9, 9, 5, 5]
[5, 5, 9, 9, 9, 5, 8, 8, 8, 5, 9, 9, 9, 5, 5, 5, 5, 5, 5, 9, 9, 9, 5, 8, 8, 8, 5, 9, 9, 9, 5, 5]
[5, 5, 9, 9, 9, 5, 8, 8, 8, 5, 9, 9, 9, 5, 5, 5, 5, 5, 5, 9, 9, 9, 5, 8, 8, 8, 5, 9, 9, 9, 5, 5]
[5, 5, 5, 5, 5, 5, 5, 5, 5, 5, 5, 5, 5, 5, 5, 5, 5, 5, 5, 5, 5, 5, 5, 5, 5, 5, 5, 5, 5, 5, 5, 5]
[5, 5, 8, 8, 8, 5, 2, 0, 2, 5, 9, 9, 9, 5, 5, 5, 5, 5, 5, 8, 8, 8, 5, 2, 0, 2, 5, 8, 8, 8, 5, 5]
[5, 5, 8, 8, 8, 5, 0, 8, 2, 5, 9, 9, 9, 5, 5, 5, 5, 5, 5, 8, 8, 8, 5, 0, 8, 0, 5, 8, 8, 8, 5, 5]
[5, 5, 8, 8, 8, 5, 2, 0, 0, 5, 9, 9, 9, 5, 5, 5, 5, 5, 5, 8, 8, 8, 5, 2, 0, 2, 5, 8, 8, 8, 5, 5]
[5, 5, 5, 5, 5, 5, 5, 5, 5, 5, 5, 5, 5, 5, 5, 5, 5, 5, 5, 5, 5, 5, 5, 5, 5, 5, 5, 5, 5, 5, 5, 5]
[5, 5, 9, 9, 9, 5, 8, 8, 8, 5, 8, 8, 8, 5, 5, 5, 5, 5, 5, 9, 9, 9, 5, 8, 8, 8, 5, 9, 9, 9, 5, 5]
[5, 5, 9, 9, 9, 5, 8, 8, 8, 5, 8, 8, 8, 5, 5, 5, 5, 5, 5, 9, 9, 9, 5, 8, 8, 8, 5, 9, 9, 9, 5, 5]
[5, 5, 9, 9, 9, 5, 8, 8, 8, 5, 8, 8, 8, 5, 5, 5, 5, 5, 5, 9, 9, 9, 5, 8, 8, 8, 5, 9, 9, 9, 5, 5]
[5, 5, 5, 5, 5, 5, 5, 5, 5, 5, 5, 5, 5, 5, 5, 5, 5, 5, 5, 5, 5, 5, 5, 5, 5, 5, 5, 5, 5, 5, 5, 5]
[5, 5, 5, 5, 5, 5, 5, 5, 5, 5, 5, 5, 5, 5, 5, 5, 5, 5, 5, 5, 5, 5, 5, 5, 5, 5, 5, 5, 5, 5, 5, 5]
[5, 5, 5, 5, 5, 5, 5, 5, 5, 5, 5, 5, 5, 5, 5, 5, 5, 5, 5, 5, 5, 5, 5, 5, 5, 5, 5, 5, 5, 5, 5, 5]
[5, 5, 5, 5, 5, 5, 5, 5, 5, 5, 5, 5, 5, 5, 5, 5, 5, 5, 5, 5, 5, 5, 5, 5, 5, 5, 5, 5, 5, 5, 5, 5]
[5, 5, 5, 5, 5, 5, 5, 5, 5, 5, 5, 5, 5, 5, 5, 5, 2, 2, 2, 4, 4, 4, 4, 4, 4, 4, 4, 4, 2, 2, 2, 5]
[5, 5, 5, 5, 5, 5, 5, 5, 5, 5, 5, 5, 5, 5, 5, 5, 2, 4, 4, 4, 4, 4, 4, 4, 4, 4, 4, 4, 4, 4, 2, 5]
[5, 5, 8, 8, 8, 5, 9, 9, 9, 5, 9, 9, 9, 5, 5, 5, 2, 4, 9, 9, 9, 4, 9, 9, 9, 4, 9, 9, 9, 4, 2, 5]
[5, 5, 8, 8, 8, 5, 9, 9, 9, 5, 9, 9, 9, 5, 5, 5, 4, 4, 9, 9, 9, 4, 9, 9, 9, 4, 9, 9, 9, 4, 4, 5]
[5, 5, 8, 8, 8, 5, 9, 9, 9, 5, 9, 9, 9, 5, 5, 5, 4, 4, 9, 9, 9, 4, 9, 9, 9, 4, 9, 9, 9, 4, 4, 5]
[5, 5, 5, 5, 5, 5, 5, 5, 5, 5, 5, 5, 5, 5, 5, 5, 4, 4, 4, 4, 4, 4, 4, 4, 4, 4, 4, 4, 4, 4, 4, 5]
[5, 5, 8, 8, 8, 5, 0, 2, 2, 5, 8, 8, 8, 5, 5, 5, 4, 4, 9, 9, 9, 4, 0, 2, 2, 4, 9, 9, 9, 4, 4, 5]
[5, 5, 8, 8, 8, 5, 0, 8, 0, 5, 8, 8, 8, 5, 5, 5, 4, 4, 9, 9, 9, 4, 0, 8, 0, 4, 9, 9, 9, 4, 4, 5]
[5, 5, 8, 8, 8, 5, 2, 2, 0, 5, 8, 8, 8, 5, 5, 5, 4, 4, 9, 9, 9, 4, 0, 2, 2, 4, 9, 9, 9, 4, 4, 5]
[5, 5, 5, 5, 5, 5, 5, 5, 5, 5, 5, 5, 5, 5, 5, 5, 4, 4, 4, 4, 4, 4, 4, 4, 4, 4, 4, 4, 4, 4, 4, 5]
[5, 5, 9, 9, 9, 5, 9, 9, 9, 5, 8, 8, 8, 5, 5, 5, 4, 4, 9, 9, 9, 4, 9, 9, 9, 4, 9, 9, 9, 4, 4, 5]
[5, 5, 9, 9, 9, 5, 9, 9, 9, 5, 8, 8, 8, 5, 5, 5, 4, 4, 9, 9, 9, 4, 9, 9, 9, 4, 9, 9, 9, 4, 4, 5]
[5, 5, 9, 9, 9, 5, 9, 9, 9, 5, 8, 8, 8, 5, 5, 5, 2, 4, 9, 9, 9, 4, 9, 9, 9, 4, 9, 9, 9, 4, 2, 5]
[5, 5, 5, 5, 5, 5, 5, 5, 5, 5, 5, 5, 5, 5, 5, 5, 2, 4, 4, 4, 4, 4, 4, 4, 4, 4, 4, 4, 4, 4, 2, 5]
[5, 5, 5, 5, 5, 5, 5, 5, 5, 5, 5, 5, 5, 5, 5, 5, 2, 2, 2, 4, 4, 4, 4, 4, 4, 4, 4, 4, 2, 2, 2, 5]
[5, 5, 5, 5, 5, 5, 5, 5, 5, 5, 5, 5, 5, 5, 5, 5, 5, 5, 5, 5, 5, 5, 5, 5, 5, 5, 5, 5, 5, 5, 5, 5]
